20
20
222222a1111111111111
222222a1111111111111
222222a1111111111111
222222a1111111111111
222222a1111111111111
222222a1111111111111
222222a1111111111111
222222a1111111111111
222222a1111111111111
222222a1111111111111
bbbbbba1111111111111
333333a1111111111111
333333a1111111111111
333333eddddddddddddd
333333c4444444444444
333333c4444444444444
333333c4444444444444
333333c4444444444444
333333c4444444444444
333333c4444444444444